30
X
##############################
#                            #
#   ######                   #
#        #                   #
#        #                   #
#        #                   #
#                            #
#                            #
#                            #
##############################
